**********************************************************************
I            *********************************************************
************ ******************                            ***********
************ ****               **************************************
************ ******************                                 ******
************ ****************** ******************************* ******
************                       **************************** ******
************ *********************                       ****** ******
************ ********************* ******************** ******* ******
***          ****                  ******************** ******* ******
*************************** *********************************** ******
*************************** **********                          ******
******                      ******************************************
*********** *************** ******************************************
*********** *************** ******************************************
*********** ***************                                      *****
*********** **************************************************** *****
*********** **************************************************** *****
***********                                  ******************* *****
************************ ***************** ********              *****
*****                    ***************** ********************* *****
************************ *****************         ************* *****
**************************************************************** *****
********                                                         *****
********************************* ******************** ***************
********************************* ******************** ***************
*****                             ******          **** ***************
********************************* ****** *************         *******
********************************* ****** ********************* *******
*******                           ******                 ***** *******
******* ************************* ****** ********************* *******
******* ************************* ****** ********************* *******
******* ************************* ******                       *******
******* ************************* ****************** *****************
******* *******************       ****************** *****************
******* ******************* ************************ *****************
******* *****               ************************            ******
**      ***** ********************************************************
******* ***** ********************************************************
******* *****                                               **********
******* ***** ********************************************* **********
******* *****         ************************************* **********
******* ************* **********                   ********        ***
******* ************* **************************** ******** **********
******* *************        ********************* ******** **********
******* ******************** *********                      **********
******* ******************** *************** *************************
*******               ****** ***************                   *******
********************* ****** *************** *************************
********************* ****** *****************************************
********************* ****** *****************************************
*****                 ******                                    ******
********************* *********************** ***************** ******
********************* *************** ******* ***************** ******
******                *************** *******    ************** ******
****** ****************************** ********** ************** ******
****** ****************************** **********            *** ******
*****              ************                  ************** ******
****** ******************************************************** ******
****** ******************************************************** ******
******                                                 ******** ******
***************************************************** ********* ******
***************************************************** ********* ******
**                                                    ********* ******
** ************************************************************ ******
** ***                                                          ******
** *** ***************************************************************
** *** ***************************************************************
******                                                               F
**********************************************************************


